name	display_name
actions	Actions
adjectives	Adjectives
alternates_allergens	Alternates & Allergens
animals	Animals
athletics	Athletics
board_games	Board Games
casual_clothes	Casual Clothes
cities	Cities
colours	Colours
common_food	Common Food
common_food_phrases	Common Food Phrases
computing	Computing
condiments	Condiments
conversational	Conversational
countries	Countries
deaf_terminology	Deaf Terminology
disability_awareness	Disability Awareness
drinks	Drinks
family	Family
farmyard_animals	Farmyard Animals
feelings	Feelings
first_aid	First Aid
fish	Fish 
food	Food
formal_clothes	Formal Clothes
fruit	Fruit
games	Games
greetings	Greetings
hobbies	Hobbies
lgbtqia	LGBTQIA+
marriage	Marriage
martial_arts	Martial Arts
meat	Meat
medical	Medical
mental_health	Mental Health
numbers	Numbers
other_clothes	Other Clothes
physical_health	Physical Health
places	Places
question_forms	Question Forms
relationship_terms	Relationship Terminology
relationships	Relationships
reptiles	Reptiles
sign_of_the_week	Sign of the Week
social_events	Social Events
spelt	Spelt Out
sports	Sports
sports_terms	Sports Terminology
travel	Travel
vegetables	Vegetables
video_games	Video Games
woodland_animals	Woodland Animals
zoo_animals	Zoo Animals